5,15,1

06,06,06,06,06,06,06,06,06,06,06,06,06,06,03,
10,11,11,11,11,11,11,11,11,11,11,11,11,11,12,
10,11,11,11,11,11,11,11,11,11,11,11,11,11,11,
10,11,11,11,11,11,11,11,11,11,11,11,11,11,11,
10,11,11,11,11,11,11,11,11,11,11,11,11,11,11,