6,15,1

00,11,11,11,11,11,11,11,11,11,11,11,11,11,12,
00,11,11,11,11,11,11,11,11,11,11,11,11,11,12,
00,11,11,11,11,11,11,11,11,11,11,11,11,11,12,
00,11,11,11,11,11,11,11,11,11,11,11,11,11,11,
00,11,11,11,11,11,11,11,11,11,11,11,11,11,11,
00,11,11,11,11,11,11,11,11,11,11,11,11,11,11,