6,15,1

10,11,11,11,11,11,11,11,11,11,11,11,11,11,12,
10,11,11,11,11,11,11,11,11,11,11,11,11,11,12,
10,11,11,11,11,11,11,11,11,11,11,11,11,11,12,
10,11,11,11,11,11,11,11,11,11,11,11,11,11,11,
10,11,11,11,11,11,11,11,11,11,11,11,11,11,11,
10,11,11,11,11,11,11,11,11,11,11,11,11,11,11,