15,25,1

00,00,00,00,00,00,00,00,00,00,00,00,00,00,00,00,00,00,00,00,00,00,00,00,00
00,00,00,00,00,00,00,01,02,03,00,00,00,01,02,03,04,05,06,00,00,00,00,00,00
00,00,00,00,00,00,00,04,05,06,00,00,00,07,08,09,10,11,12,00,00,00,00,00,00
00,00,00,00,00,00,00,07,08,09,00,00,00,13,14,15,16,17,18,00,00,00,00,00,00
00,00,00,00,00,00,00,10,11,12,00,00,00,19,20,21,22,23,24,00,00,00,00,00,00
00,00,00,00,00,00,00,13,14,15,00,00,00,25,26,27,28,29,30,00,00,00,00,00,00
00,00,00,00,00,00,00,00,00,00,00,00,00,31,32,33,34,35,36,00,00,00,00,00,00
00,00,00,00,00,00,00,00,00,00,00,00,00,37,38,39,40,41,42,00,00,00,00,00,00
00,00,00,00,00,00,00,00,00,00,00,00,00,43,44,45,46,47,48,00,00,00,00,00,00
00,00,00,00,00,00,00,00,00,00,00,00,00,49,50,51,52,53,54,00,00,00,00,00,00
00,00,00,00,00,00,00,00,00,00,00,00,00,55,56,57,58,59,60,00,00,00,00,00,00
00,00,00,00,00,00,00,00,00,00,00,00,00,00,00,00,00,00,00,00,00,00,00,00,00
13,14,14,14,14,14,14,14,14,14,14,14,14,14,14,14,14,14,14,14,14,14,14,14,15,
05,05,06,06,07,07,08,08,08,08,08,08,08,08,08,08,08,08,08,08,08,08,08,08,09,
07,08,08,08,08,08,08,08,08,08,08,08,08,08,08,08,08,08,08,08,08,08,08,08,09,
