32,64,1


93,94,93,94,93,94,93,94,93,94,93,94,93,94,93,94,93,94,93,94,93,94,93,94,93,94,93,94,93,94,93,94,93,94,93,94,93,94,93,94,93,94,93,94,93,94,93,94,93,94,93,94,93,94,93,94,93,94,93,94,93,94,93,94,
101,102,101,102,101,102,101,102,101,102,101,102,101,102,101,102,101,102,101,102,101,102,101,102,101,102,101,102,101,102,101,102,101,102,101,102,101,102,101,102,101,102,101,102,101,102,101,102,101,102,101,102,101,102,101,102,101,102,101,102,101,102,101,102,
93,94,93,94,93,94,93,94,93,94,93,94,93,94,93,94,93,94,93,94,93,94,93,94,93,94,93,94,93,94,93,94,93,94,93,94,93,94,93,94,93,94,93,94,93,94,93,94,93,94,93,94,93,94,93,94,93,94,93,94,93,94,93,94,
101,102,101,102,101,102,101,102,101,102,101,102,101,102,101,102,101,102,101,102,101,102,101,102,101,102,101,102,101,102,101,102,101,102,101,102,101,102,101,102,101,102,101,102,101,102,101,102,101,102,101,102,101,102,101,102,101,102,101,102,101,102,101,102,
93,94,93,94,93,94,93,94,93,94,93,94,93,94,93,94,93,94,93,94,93,94,93,94,93,94,93,94,93,94,93,94,93,94,93,94,93,94,93,94,93,94,93,94,93,94,93,94,93,94,93,94,93,94,93,94,93,94,93,94,93,94,93,94,
101,102,101,102,101,102,101,102,101,102,101,102,101,102,101,102,101,102,101,102,101,102,101,102,101,102,101,102,101,102,101,102,101,102,101,102,101,102,101,102,101,102,101,102,101,102,101,102,101,102,101,102,101,102,101,102,101,102,101,102,101,102,101,102,
93,94,93,94,93,94,93,94,93,94,93,94,93,94,93,94,93,94,93,94,93,94,93,94,93,94,93,94,93,94,93,94,93,94,93,94,93,94,93,94,93,94,93,94,93,94,93,94,93,94,93,94,93,94,93,94,93,94,93,94,93,94,93,94,
101,102,101,102,101,102,101,102,101,102,101,102,101,102,101,102,101,102,101,102,101,102,101,102,101,102,101,102,101,102,101,102,101,102,101,102,101,102,101,102,101,102,101,102,101,102,101,102,101,102,101,102,101,102,101,102,101,102,101,102,101,102,101,102,
93,94,93,94,93,94,93,94,93,94,93,94,93,94,93,94,93,94,93,94,93,94,93,94,93,94,93,94,93,94,93,94,93,94,93,94,93,94,93,94,93,94,93,94,93,94,93,94,93,94,93,94,93,94,93,94,93,94,93,94,93,94,93,94,
101,102,101,102,101,102,101,102,101,102,101,102,101,102,101,102,101,102,101,102,101,102,101,102,101,102,101,102,101,102,101,102,101,102,101,102,101,102,101,102,101,102,101,102,101,102,101,102,101,102,101,102,101,102,101,102,101,102,101,102,101,102,101,102,
93,94,93,94,93,94,93,94,93,94,93,94,93,94,93,94,93,94,93,94,93,94,93,94,93,94,93,94,93,94,93,94,93,94,93,94,93,94,93,94,93,94,93,94,93,94,93,94,93,94,93,94,93,94,93,94,93,94,93,94,93,94,93,94,
101,102,101,102,101,102,101,102,101,102,101,102,101,102,101,102,101,102,101,102,101,102,101,102,101,102,101,102,101,102,101,102,101,102,101,102,101,102,101,102,101,102,101,102,101,102,101,102,101,102,101,102,101,102,101,102,101,102,101,102,101,102,101,102,
93,94,93,94,93,94,93,94,93,94,93,94,93,94,93,94,93,94,93,94,93,94,93,94,93,94,93,94,93,94,93,94,93,94,93,94,93,94,93,94,93,94,93,94,93,94,93,94,93,94,93,94,93,94,93,94,93,94,93,94,93,94,93,94,
101,102,101,102,101,102,101,102,101,102,101,102,101,102,101,102,101,102,101,102,101,102,101,102,101,102,101,102,101,102,101,102,101,102,101,102,101,102,101,102,101,102,101,102,101,102,101,102,101,102,101,102,101,102,101,102,101,102,101,102,101,102,101,102,
93,94,93,94,93,94,93,94,93,94,93,94,93,94,93,94,93,94,93,94,93,94,93,94,93,94,93,94,93,94,93,94,93,94,93,94,93,94,93,94,93,94,93,94,93,94,93,94,93,94,93,94,93,94,93,94,93,94,93,94,93,94,93,94,
101,102,101,102,101,102,101,102,101,102,101,102,101,102,101,102,101,102,101,102,101,102,101,102,101,102,101,102,101,102,101,102,101,102,101,102,101,102,101,102,101,102,101,102,101,102,101,102,101,102,101,102,101,102,101,102,101,102,101,102,101,102,101,102,
93,94,93,94,93,94,93,94,93,94,93,94,93,94,93,94,93,94,93,94,93,94,93,94,93,94,93,94,93,94,93,94,93,94,93,94,93,94,93,94,93,94,93,94,93,94,93,94,93,94,93,94,93,94,93,94,93,94,93,94,93,94,93,94,
101,102,101,102,101,102,101,102,101,102,101,102,101,102,101,102,101,102,101,102,101,102,101,102,101,102,101,102,101,102,101,102,101,102,101,102,101,102,101,102,101,102,101,102,101,102,101,102,101,102,101,102,101,102,101,102,101,102,101,102,101,102,101,102,
93,94,93,94,93,94,93,94,93,94,93,94,93,94,93,94,93,94,93,94,93,94,93,94,93,94,93,94,93,94,93,94,93,94,93,94,93,94,93,94,93,94,93,94,93,94,93,94,93,94,93,94,93,94,93,94,93,94,93,94,93,94,93,94,
101,102,101,102,101,102,101,102,101,102,101,102,101,102,101,102,101,102,101,102,101,102,101,102,101,102,101,102,101,102,101,102,101,102,101,102,101,102,101,102,101,102,101,102,101,102,101,102,101,102,101,102,101,102,101,102,101,102,101,102,101,102,101,102,
93,94,93,94,93,94,93,94,93,94,93,94,93,94,93,94,93,94,93,94,93,94,93,94,93,94,93,94,93,94,93,94,93,94,93,94,93,94,93,94,93,94,93,94,93,94,93,94,93,94,93,94,93,94,93,94,93,94,93,94,93,94,93,94,
101,102,101,102,101,102,101,102,101,102,101,102,101,102,101,102,101,102,101,102,101,102,101,102,101,102,101,102,101,102,101,102,101,102,101,102,101,102,101,102,101,102,101,102,101,102,101,102,101,102,101,102,101,102,101,102,101,102,101,102,101,102,101,102,
93,94,93,94,93,94,93,94,93,94,93,94,93,94,93,94,93,94,93,94,93,94,93,94,93,94,93,94,93,94,93,94,93,94,93,94,93,94,93,94,93,94,93,94,93,94,93,94,93,94,93,94,93,94,93,94,93,94,93,94,93,94,93,94,
101,102,101,102,101,102,101,102,101,102,101,102,101,102,101,102,101,102,101,102,101,102,101,102,101,102,101,102,101,102,101,102,101,102,101,102,101,102,101,102,101,102,101,102,101,102,101,102,101,102,101,102,101,102,101,102,101,102,101,102,101,102,101,102,
93,94,93,94,93,94,93,94,93,94,93,94,93,94,93,94,93,94,93,94,93,94,93,94,93,94,93,94,93,94,93,94,93,94,93,94,93,94,93,94,93,94,93,94,93,94,93,94,93,94,93,94,93,94,93,94,93,94,93,94,93,94,93,94,
101,102,101,102,101,102,101,102,101,102,101,102,101,102,101,102,101,102,101,102,101,102,101,102,101,102,101,102,101,102,101,102,101,102,101,102,101,102,101,102,101,102,101,102,101,102,101,102,101,102,101,102,101,102,101,102,101,102,101,102,101,102,101,102,
93,94,93,94,93,94,93,94,93,94,93,94,93,94,93,94,93,94,93,94,93,94,93,94,93,94,93,94,93,94,93,94,93,94,93,94,93,94,93,94,93,94,93,94,93,94,93,94,93,94,93,94,93,94,93,94,93,94,93,94,93,94,93,94,
101,102,101,102,101,102,101,102,101,102,101,102,101,102,101,102,101,102,101,102,101,102,101,102,101,102,101,102,101,102,101,102,101,102,101,102,101,102,101,102,101,102,101,102,101,102,101,102,101,102,101,102,101,102,101,102,101,102,101,102,101,102,101,102,
93,94,93,94,93,94,93,94,93,94,93,94,93,94,93,94,93,94,93,94,93,94,93,94,93,94,93,94,93,94,93,94,93,94,93,94,93,94,93,94,93,94,93,94,93,94,93,94,93,94,93,94,93,94,93,94,93,94,93,94,93,94,93,94,
101,102,101,102,101,102,101,102,101,102,101,102,101,102,101,102,101,102,101,102,101,102,101,102,101,102,101,102,101,102,101,102,101,102,101,102,101,102,101,102,101,102,101,102,101,102,101,102,101,102,101,102,101,102,101,102,101,102,101,102,101,102,101,102,
93,94,93,94,93,94,93,94,93,94,93,94,93,94,93,94,93,94,93,94,93,94,93,94,93,94,93,94,93,94,93,94,93,94,93,94,93,94,93,94,93,94,93,94,93,94,93,94,93,94,93,94,93,94,93,94,93,94,93,94,93,94,93,94,
101,102,101,102,101,102,101,102,101,102,101,102,101,102,101,102,101,102,101,102,101,102,101,102,101,102,101,102,101,102,101,102,101,102,101,102,101,102,101,102,101,102,101,102,101,102,101,102,101,102,101,102,101,102,101,102,101,102,101,102,101,102,101,102,
00,00,00,00,00,00,00,00,00,00,00,00,00,00,00,00,00,00,00,00,00,00,00,00,00,00,00,00,00,00,00,00,00,00,00,00,00,00,00,00,00,00,00,00,00,00,00,00,00,00,00,00,00,00,00,00,00,00,00,00,00,00,00,00,
